#############
#     o     #
#     #     #
#     x     #
#     ^     #
#############