     #####
    ##   #
    #    #
  ###    ######
  #o#o# ##o   #
### ###  ##   #
#   #  x  ## ##
#     x^x     #
#   #  x  #   #
######   ### ##
 #  o## #### #
 #           #
 ##  #########
  ####