 ###########
##         ##
#  x     x  #
# x# #o# #x #
#    #%#    #####
#  ###o###  #   #
#  o%o^o%o      #
#  ###o###  #   #
#    #%#    #####
# x# #o# #x #
#  x     x  #
##         ##
 ###########