#####################
#                   #
# x    o        x   #
#          x        #
#    x              #
#        o     o    #
#     o             #
# x        x        #
#    o   o          #
#              o    #
#    x     x        #
#     ^   o         #
#  o                #
#    x     o    x   #
#                   #
#####################
