###########
#  o x  xo#
#  x    x #
#o#  ^   o#
###########