#######
#  o  #
# x^x #
#  o  #
####### 