 ##########
##   $ o  ##
#  x  #x   #
#o   x x  o#
##$       ##
 ##########