 ##########
##   o o  ##
#    #     #
#    x x   #
##   ^    ##
 ##########