 ###########
##    o    ##
#     #     #
#     x     #
##    ^    ##
 ###########