 ############
##    oo    ##
#            #
#     xx     #
##    ^     ##
 ############