#########
####o####
#### ####
#       #
#  # #  #
#  x x  #
#     # #
#   ^ #o#
#########
