#########
####o####
####o####
#       #
#       #
#  ###  #
#  x x  #
#   ^   #
#########
