########
##o  o##
##   ###
##    ##
## xx ##
##  ^ ##
########