########
##o  o##
###  ###
##    ##
## xx ##
##  ^ ##
########
