#######
#     #
#     #
#  x  #
#  ^  #
#     #
#######