 
######
#  x #
#  ^ #
#o   #
######