      ###
      #o#
  #####o#####
 ##         ##
##           ##
#   # # # #   #
#  ##     ##  #
# ##  # #  ## #
#     x^x     #
####  ###  ####
   #### ####