#########
####%####
#### ####
#       #
#  # #  #
#    x  #
#     # #
#     #$#
#########
